{
	"name":"Env-Vee",
	"bpm":130,
	"events":[
		{
			"time":1000,
			"type":0,
			"extraData":{
				"sides":6,
				"fadeColor": [255, 0, 0]
			},
			"map":[
				["","","","",1 ,"","","","","","","","","","","","","","","","","","","","","","","","","","","","","","","","","","","","","","","","","","","","","","","",1 ,"","","","","",1 ,"","","","","",1 ,"","","","","",1 ,"","","","","","","","","","","",1 ,"","","","","","","","","","","","","","","","","",1 ,"","","","","",1 ,"","","","","","","","","",1 ,"","","","","","","","","","","","","",1 ,"","","","","","","","","","","","",1 ,"","","","","","","","","","","","","",1 ,"","","","","","","","","","","","",1 ,"",1 ],
				["","","","","","","","","","",1 ,"","","","","","","","","","","","","","","","","","","","","","","",1 ,"","","","","","","","","","","","","","","","","",1 ,"","","","","","","","","","","",1 ,"","","","","","","","","","","",1 ,"",1 ,"","","",1 ,"","","","","",1 ,"",1 ,1 ,"","",1 ,"","","","","",1 ,"","","","","","","","",1 ,"","","","","","","","","","","","",1 ,"","","","","","","","","",1 ,"","","","","","","","","","","","","",1 ,"","","","","","","","","","","","",1 ,"","","","","","","","","","","",1 ,""],
				["","","","","","","","","","","","","","","","",1 ,"","","","","","","","","","","",1 ,"","","","","","","","","","","","","","","","","",1 ,"","","","","","","","","","","",1 ,"","","","","","","","","","","",1 ,"","","","","",1 ,"","","","","","","","","","","","","","","","","",1 ,"","","","","","","","","","","","","","","","","","","",1 ,"","","","","","","","","",1 ,"","","","","","","","","","","","","","","","","","","","","","","",1 ,"","","","","","","","","","","","","","","","",1 ,"","","","","","",""],
				["","","","","","","","","","","","","","","","","","","","","","",1 ,"","","","","","","","","","","","","","","","","",1 ,"","","","","","","","","","","",1 ,"","","","","",1 ,"","","","","",1 ,"","","","","","","","","","","","","","","","","","","","","","","",1 ,"","","","","","","","","","","","","","","","","","","","","","","",1 ,"","","","","","","","","","","","","","","","","","","","","","","",1 ,"","","",1 ,"","","","","","","","","","","","","","","",1 ,"","","","","","","",1 ,"","","","","","","",""],
				["","","","","","","","","","","","","","","","","","","","","","","","","","","","","","","","","","","","","","","","","","","","","","",1 ,"","","","","","","","","","","",1 ,"","","","","",1 ,"","","","","",1 ,"","","","","",1 ,"","","","","",1 ,"",1 ,"","","",1 ,"",1 ,"","",1 ,1 ,"","","","","",1 ,"","","","","","","","","","","","","","","","","","","",1 ,"","","","","","","","","","","","","","","","","","","","","","","","","","","","","","","","","",1 ,"","","","","","","",1 ,"","","","","",1 ,"","","",""],
				["","","","","","","","","","","","","","","","","","","","","","","","","","","","","","","","","","","","","","","","",1 ,"","","","","","","","","","","","","","","","","","","","","","","","","","","","","",1 ,"","","","","","","","","","","","","","","","","",1 ,"","","","","","","","","","","","","","","","","","","","","","","","","","","","","",1 ,"","","","","","","","","","","","","","","","","","","","",1 ,"","","","","","","","","","","","",1 ,"","","","","","","","","","","","","","",1 ,"","","","",""]
			],
			"sideMap":["","","","","","","","",""]
		}	
	]
}
